##############################################################################  
    ##              ##                                          ##          ##
##  ##  ##  ##########  ######  ##################  ##########  ##########  ##
##      ##                  ##      ##          ##  ##      ##          ##  ##
##########################  ######  ##  ######  ##  ##  ##  ##  ######  ##  ##
##      ##              ##      ##  ##  ##  ##  ##  ##  ##  ##  ##          ##
##  ######  ##  ##############  ######  ##  ##  ##  ##  ##  ######  ##########
##  ##      ##  ##              ##      ##      ##  ##  ##              ##  ##
##  ##  ######  ##  ##############  ##############  ##  ##############  ##  ##
##          ##      ##          ##  ##              ##          ##  ##  ##  ##
##  ######  ##########  ######  ##  ######  ##################  ##  ##  ##  ##
##  ##  ##              ##  ##  ##          ##      ##      ##      ##      ##
##  ##  ##  ##  ##########  ##  ##############  ######  ##  ##  ##############
##      ##  ##  ##          ##                  ##      ##  ##      ##      ##
##########  ######  ##############################  ######  ######  ##  ##  ##
##      ##      ##      ##          ##      ##      ##  ##      ##      ##  ##
##  ##  ######  ######  ##  ######  ##  ##  ######  ##  ##################  ##
##  ##                  ##      ##      ##                                   G
##############################################################################
